"name": "Iron Sword",	"name": "鉄の剣",
"name": "Steel Sword",	"name": "鋼の剣",
"name": "Silver Sword",	"name": "銀の剣 ",
"name": "Silver Sword+",	"name": "銀の剣+",
"name": "Armorslayer",	"name": "アーマーキラー",
"name": "Armorslayer+",	"name": "アーマーキラー+",
"name": "Brave Sword",	"name": "勇者の剣",
"name": "Brave Sword+",	"name": "勇者の剣+",
"name": "Killing Edge",	"name": "キルソード",
"name": "Killing Edge+",	"name": "キルソード+",
"name": "Ruby Sword",	"name": "旭日の剣",
"name": "Ruby Sword+",	"name": "旭日の剣+",
"name": "Wo Dao",	"name": "倭刀",
"name": "Wo Dao+",	"name": "倭刀+",
"name": "Binding Blade",	"name": "封印の剣",
"name": "Durandal",	"name": "デュランダル",
"name": "Falchion",	"name": "ファルシオン",
"name": "Folkvangr",	"name": "フォルクヴァング ",
"name": "Mystletainn",	"name": "ミストルティン",
"name": "Raijinto",	"name": "雷神刀",
"name": "Sieglinde",	"name": "ジークリンデ",
"name": "Sol Katti",	"name": "ソール・カティ",
"name": "Tyrfing",	"name": "ティルフィング",
"name": "Yato",	"name": "夜刀神",
"name": "Fire",	"name": "ファイアー",
"name": "Elfire",	"name": "エルファイアー",
"name": "Bolganone",	"name": "ボルガノン",
"name": "Bolganone+",	"name": "ボルガノン+",
"name": "Flux",	"name": "ミィル",
"name": "Ruin",	"name": "ルイン",
"name": "Fenrir",	"name": "ノスフェラート",
"name": "Fenrir+",	"name": "ノスフェラート+",
"name": "Raudrblade",	"name": "ラウアブレード",
"name": "Raudrblade+",	"name": "ラウアブレード+",
"name": "Raudrraven",	"name": "ラウアレイヴン",
"name": "Raudrraven+",	"name": "ラウアレイヴン+",
"name": "Raudrwolf",	"name": "ラウアウルフ",
"name": "Raudrwolf+",	"name": "ラウアウルフ+",
"name": "Brynhildr",	"name": "ブリュンヒルデ",
"name": "Cymbeline",	"name": "シムベリン",
"name": "Iron Axe",	"name": "鉄の斧",
"name": "Steel Axe",	"name": "鋼の斧",
"name": "Silver Axe",	"name": "銀の斧",
"name": "Silver Axe+",	"name": "銀の斧+",
"name": "Brave Axe",	"name": "勇者の斧",
"name": "Brave Axe+",	"name": "勇者の斧+",
"name": "Emerald Axe",	"name": "深緑の斧",
"name": "Emerald Axe+",	"name": "深緑の斧+",
"name": "Hammer",	"name": "ハンマー",
"name": "Hammer+",	"name": "ハンマー+",
"name": "Killer Axe",	"name": "キラーアクス",
"name": "Killer Axe+",	"name": "キラーアクス+",
"name": "Armads",	"name": "アルマーズ",
"name": "Hauteclere",	"name": "オートクレール",
"name": "Noatun",	"name": "ノーアトゥーン",
"name": "Wind",	"name": "ウインド",
"name": "Elwind",	"name": "エルウインド",
"name": "Rexcalibur",	"name": "レクスカリバー",
"name": "Gronnblade",	"name": "グルンブレード",
"name": "Gronnblade+",	"name": "グルンブレード+",
"name": "Gronnraven",	"name": "グルンレイヴン",
"name": "Gronnraven+",	"name": "グルンレイヴン+",
"name": "Gronnwolf",	"name": "グルンウルフ",
"name": "Gronnwolf+",	"name": "グルンウルフ+",
"name": "Excalibur",	"name": "エクスカリバー",
"name": "Naga",	"name": "ナーガ",
"name": "Iron Lance",	"name": "鉄の槍",
"name": "Steel Lance",	"name": "鋼の槍",
"name": "Silver Lance",	"name": "銀の槍",
"name": "Silver Lance+",	"name": "銀の槍+",
"name": "Brave Lance",	"name": "勇者の槍",
"name": "Brave Lance+",	"name": "勇者の槍+",
"name": "Heavy Spear",	"name": "貫きの槍",
"name": "Heavy Spear+",	"name": "貫きの槍+",
"name": "Killer Lance",	"name": "キラーランス",
"name": "Killer Lance+",	"name": "キラーランス+",
"name": "Sapphire Lance",	"name": "蒼海の槍",
"name": "Sapphire Lance+",	"name": "蒼海の槍+",
"name": "Fensalir",	"name": "フェンサリル",
"name": "Siegmund",	"name": "ジークムント",
"name": "Thunder",	"name": "サンダー",
"name": "Elthunder",	"name": "エルサンダー",
"name": "Thoron",	"name": "トロン",
"name": "Blarblade",	"name": "ブラーブレード",
"name": "Blarblade+",	"name": "ブラーブレード+",
"name": "Blarwolf",	"name": "ブラーウルフ",
"name": "Blarwolf+",	"name": "ブラーウルフ+",
"name": "Blarraven",	"name": "ブラーレイヴン",
"name": "Blarraven+",	"name": "ブラーレイヴン+",
"name": "Dire Thunder",	"name": "ダイムサンダ",
"name": "Aura",	"name": "オーラ",
"name": "Fire Breath",	"name": "火のブレス",
"name": "Fire Breath+",	"name": "火のブレス+",
"name": "Flametongue",	"name": "灼熱のブレス",
"name": "Flametongue+",	"name": "灼熱のブレス+",
"name": "Lightning Breath",	"name": "雷のブレス",
"name": "Lightning Breath+",	"name": "雷のブレス+",
"name": "Light Breath",	"name": "光のブレス",
"name": "Light Breath+",	"name": "光のブレス+",
"name": "Dark Breath",	"name": "闇のブレス",
"name": "Dark Breath+",	"name": "闇のブレス+",
"name": "Iron Bow",	"name": "鉄の弓",
"name": "Steel Bow",	"name": "鋼の弓",
"name": "Silver Bow",	"name": "銀の弓",
"name": "Silver Bow+",	"name": "銀の弓+",
"name": "Assassin's Bow",	"name": "暗器殺しの弓",
"name": "Assassin's Bow+",	"name": "暗器殺しの弓+",
"name": "Brave Bow",	"name": "勇者の弓",
"name": "Brave Bow+",	"name": "勇者の弓+",
"name": "Killer Bow",	"name": "キラーボウ",
"name": "Killer Bow+",	"name": "キラーボウ+",
"name": "Fujin Yumi",	"name": "風神弓",
"name": "Parthia",	"name": "パルティア",
"name": "Iron Dagger",	"name": "鉄の暗器",
"name": "Steel Dagger",	"name": "鋼の暗器",
"name": "Silver Dagger",	"name": "銀の暗器",
"name": "Silver Dagger+",	"name": "銀の暗器+",
"name": "Poison Dagger",	"name": "秘毒の暗器",
"name": "Poison Dagger+",	"name": "秘毒の暗器+",
"name": "Rogue Dagger",	"name": "盗賊の暗器",
"name": "Rogue Dagger+",	"name": "盗賊の暗器+",
"name": "Smoke Dagger",	"name": "紫煙の暗器",
"name": "Smoke Dagger+",	"name": "紫煙の暗器+",
"name": "Deathly Dagger",	"name": "死神の暗器",
"name": "Assault",	"name": "アサルト",
"name": "Absorb",	"name": "アブゾーブ",
"name": "Fear",	"name": "フィアー",
"name": "Gravity",	"name": "グラビティ",
"name": "Pain",	"name": "ペイン",
"name": "Panic",	"name": "パニック",
"name": "Slow",	"name": "スロウ",
"name": "Rally Attack",	"name": "攻撃の応援",
"name": "Rally Speed",	"name": "速さの応援",
"name": "Rally Defense",	"name": "守備の応援",
"name": "Rally Resistance",	"name": "魔防の応援",
"name": "Harsh Command",	"name": "一喝",
"name": "Ardent Sacrifice",	"name": "献身",
"name": "Reciprocal Aid",	"name": "相互援助",
"name": "Draw Back",	"name": "引き寄せ",
"name": "Pivot",	"name": "回り込み",
"name": "Reposition",	"name": "引き戻し",
"name": "Shove",	"name": "体当たり",
"name": "Smite",	"name": "ぶちかまし",
"name": "Swap",	"name": "入れ替え",
"name": "Heal",	"name": "ライブ",
"name": "Mend",	"name": "リライブ",
"name": "Reconcile",	"name": "ヒール",
"name": "Recover",	"name": "リカバー",
"name": "Physic",	"name": "リブロー",
"name": "Martyr",	"name": "セインツ",
"name": "Rehabilitate",	"name": "リバース",
"name": "Dance",	"name": "踊る",
"name": "Sing",	"name": "歌う",
"name": "Night Sky",	"name": "星影",
"name": "Dragon Gaze",	"name": "伏竜",
"name": "Glowing Ember",	"name": "蛍火",
"name": "Daylight",	"name": "陽影",
"name": "New Moon",	"name": "影月",
"name": "Chilling Wind",	"name": "氷点",
"name": "Retribution",	"name": "雪辱",
"name": "Glimmer",	"name": "凶星",
"name": "Astra",	"name": "流星",
"name": "Draconic Aura",	"name": "竜裂",
"name": "Dragon Fang",	"name": "竜穿",
"name": "Bonfire",	"name": "緋炎",
"name": "Ignis",	"name": "華炎",
"name": "Noontime",	"name": "夕陽",
"name": "Sol",	"name": "太陽",
"name": "Moonbow",	"name": "月虹",
"name": "Luna",	"name": "月光",
"name": "Iceberg",	"name": "氷蒼",
"name": "Glacies",	"name": "氷華",
"name": "Reprisal",	"name": "血讐",
"name": "Vengeance",	"name": "復讐",
"name": "Galeforce",	"name": "疾風迅雷",
"name": "Aether",	"name": "天空",
"name": "Rising Thunder",	"name": "砕雷",
"name": "Rising Wind",	"name": "砕風",
"name": "Rising Light",	"name": "砕光",
"name": "Rising Flame",	"name": "砕火",
"name": "Growing Thunder",	"name": "爆雷",
"name": "Blazing Thunder",	"name": "烈雷",
"name": "Growing Wind",	"name": "爆風",
"name": "Blazing Wind",	"name": "烈風",
"name": "Growing Light",	"name": "爆光",
"name": "Blazing Light",	"name": "烈光",
"name": "Growing Flame",	"name": "爆火",
"name": "Blazing Flame",	"name": "烈火",
"name": "Buckler",	"name": "小盾",
"name": "Holy Vestments",	"name": "聖衣",
"name": "Escutcheon",	"name": "長盾",
"name": "Pavise",	"name": "大盾",
"name": "Sacred Cowl",	"name": "聖兜",
"name": "Aegis",	"name": "聖盾",
"name": "Imbue",	"name": "治癒",
"name": "Heavenly Light",	"name": "天照",
"name": "Kindled-Fire Balm",	"name": "業火の祝福",
"name": "Swift-Winds Balm",	"name": "疾風の祝福",
"name": "Solid-Earth Balm",	"name": "大地の祝福",
"name": "Still-Water Balm",	"name": "静水の祝福",
"name": "Miracle",	"name": "祈り",
"name": "HP 3",	"name": "ＨＰ 1",
"name": "HP 4",	"name": "ＨＰ 2",
"name": "HP 5",	"name": "ＨＰ 3",
"name": "Attack 1",	"name": "攻撃 1",
"name": "Attack 2",	"name": "攻撃 2",
"name": "Attack 3",	"name": "攻撃 3",
"name": "Speed 1",	"name": "速さ 1",
"name": "Speed 2",	"name": "速さ 2",
"name": "Speed 3",	"name": "速さ 3",
"name": "Defense 1",	"name": "守備 1",
"name": "Defense 2",	"name": "守備 2",
"name": "Defense 3",	"name": "守備 3",
"name": "Resistance 1",	"name": "魔防 1",
"name": "Resistance 2",	"name": "魔防 2",
"name": "Resistance 3",	"name": "魔防 3",
"name": "Fury 1",	"name": "獅子奮迅 1",
"name": "Fury 2",	"name": "獅子奮迅 2",
"name": "Fury 3",	"name": "獅子奮迅 3",
"name": "Life and Death 1",	"name": "死線 1",
"name": "Life and Death 2",	"name": "死線 2",
"name": "Life and Death 3",	"name": "死線 3",
"name": "Armored Blow 1",	"name": "金剛の一撃 1",
"name": "Armored Blow 2",	"name": "金剛の一撃 2",
"name": "Armored Blow 3",	"name": "金剛の一撃 3",
"name": "Darting Blow 1",	"name": "飛燕の一撃 1",
"name": "Darting Blow 2",	"name": "飛燕の一撃 2",
"name": "Darting Blow 3",	"name": "飛燕の一撃 3",
"name": "Death Blow 1",	"name": "鬼神の一撃 1",
"name": "Death Blow 2",	"name": "鬼神の一撃 2",
"name": "Death Blow 3",	"name": "鬼神の一撃 3",
"name": "Warding Blow 1",	"name": "明鏡の一撃 1",
"name": "Warding Blow 2",	"name": "明鏡の一撃 2",
"name": "Warding Blow 3",	"name": "明鏡の一撃 3",
"name": "Defiant Atk 1",	"name": "攻撃の覚醒 1",
"name": "Defiant Atk 2",	"name": "攻撃の覚醒 2",
"name": "Defiant Atk 3",	"name": "攻撃の覚醒 3",
"name": "Defiant Spd 1",	"name": "速さの覚醒 1",
"name": "Defiant Spd 2",	"name": "速さの覚醒 2",
"name": "Defiant Spd 3",	"name": "速さの覚醒 3",
"name": "Defiant Def 1",	"name": "守備の覚醒 1",
"name": "Defiant Def 2",	"name": "守備の覚醒 2",
"name": "Defiant Def 3",	"name": "守備の覚醒 3",
"name": "Defiant Res 1",	"name": "魔防の覚醒 1",
"name": "Defiant Res 2",	"name": "魔防の覚醒 2",
"name": "Defiant Res 3",	"name": "魔防の覚醒 3",
"name": "Triangle Adept 1",	"name": "相性激化 1",
"name": "Triangle Adept 2",	"name": "相性激化 2",
"name": "Triangle Adept 3",	"name": "相性激化 3",
"name": "Close Counter",	"name": "近距離反撃",
"name": "Distant Counter",	"name": "遠距離反撃",
"name": "Svalinn Shield",	"name": "スヴェルの盾",
"name": "Seal Atk 1",	"name": "攻撃封じ 1",
"name": "Seal Atk 2",	"name": "攻撃封じ 2",
"name": "Seal Atk 3",	"name": "攻撃封じ 3",
"name": "Seal Spd 1",	"name": "速さ封じ 1",
"name": "Seal Spd 2",	"name": "速さ封じ 2",
"name": "Seal Spd 3",	"name": "速さ封じ 3",
"name": "Seal Def 1",	"name": "守備封じ 1",
"name": "Seal Def 2",	"name": "守備封じ 2",
"name": "Seal Def 3",	"name": "守備封じ 3",
"name": "Seal Res 1",	"name": "魔防封じ 1",
"name": "Seal Res 2",	"name": "魔防封じ 2",
"name": "Seal Res 3",	"name": "魔防封じ 3",
"name": "Escape Route 1",	"name": "離脱の行路 1",
"name": "Escape Route 2",	"name": "離脱の行路 2",
"name": "Escape Route 3",	"name": "離脱の行路 3",
"name": "Wings of Mercy 1",	"name": "救援の行路 1",
"name": "Wings of Mercy 2",	"name": "救援の行路 2",
"name": "Wings of Mercy 3",	"name": "救援の行路 3",
"name": "Pass 1",	"name": "すり抜け 1",
"name": "Pass 2",	"name": "すり抜け 2",
"name": "Pass 3",	"name": "すり抜け 3",
"name": "Obstruct 1",	"name": "進軍阻止 1",
"name": "Obstruct 2",	"name": "進軍阻止 2",
"name": "Obstruct 3",	"name": "進軍阻止 3",
"name": "Wary Fighter 1",	"name": "守備隊形 1",
"name": "Wary Fighter 2",	"name": "守備隊形 2",
"name": "Wary Fighter 3",	"name": "守備隊形 3",
"name": "Vantage 1",	"name": "待ち伏せ 1",
"name": "Vantage 2",	"name": "待ち伏せ 2",
"name": "Vantage 3",	"name": "待ち伏せ 3",
"name": "Quick Riposte 1",	"name": "切り返し 1",
"name": "Quick Riposte 2",	"name": "切り返し 2",
"name": "Quick Riposte 3",	"name": "切り返し 3",
"name": "Desperation 1",	"name": "攻め立て 1",
"name": "Desperation 2",	"name": "攻め立て 2",
"name": "Desperation 3",	"name": "攻め立て 3",
"name": "Brash Assault 1",	"name": "差し違え 1",
"name": "Brash Assault 2",	"name": "差し違え 2",
"name": "Brash Assault 3",	"name": "差し違え 3",
"name": "Poison Strike 1",	"name": "蛇毒 1",
"name": "Poison Strike 2",	"name": "蛇毒 2",
"name": "Poison Strike 3",	"name": "蛇毒 3",
"name": "Renewal 1",	"name": "回復 1",
"name": "Renewal 2",	"name": "回復 2",
"name": "Renewal 3",	"name": "回復 3",
"name": "Live to Serve 1",	"name": "ご奉仕の喜び 1",
"name": "Live to Serve 2",	"name": "ご奉仕の喜び 2",
"name": "Live to Serve 3",	"name": "ご奉仕の喜び 3",
"name": "Swordbreaker 1",	"name": "剣殺し 1",
"name": "Swordbreaker 2",	"name": "剣殺し 2",
"name": "Swordbreaker 3",	"name": "剣殺し 3",
"name": "Axebreaker 1",	"name": "斧殺し 1",
"name": "Axebreaker 2",	"name": "斧殺し 2",
"name": "Axebreaker 3",	"name": "斧殺し 3",
"name": "Lancebreaker 1",	"name": "槍殺し 1",
"name": "Lancebreaker 2",	"name": "槍殺し 2",
"name": "Lancebreaker 3",	"name": "槍殺し 3",
"name": "B Tomebreaker 1",	"name": "青魔殺し 1",
"name": "B Tomebreaker 2",	"name": "青魔殺し 2",
"name": "B Tomebreaker 3",	"name": "青魔殺し 3",
"name": "G Tomebreaker 1",	"name": "緑魔殺し 1",
"name": "G Tomebreaker 2",	"name": "緑魔殺し 2",
"name": "G Tomebreaker 3",	"name": "緑魔殺し 3",
"name": "R Tomebreaker 1",	"name": "赤魔殺し 1",
"name": "R Tomebreaker 2",	"name": "赤魔殺し 2",
"name": "R Tomebreaker 3",	"name": "赤魔殺し 3",
"name": "Bowbreaker 1",	"name": "弓殺し 1",
"name": "Bowbreaker 2",	"name": "弓殺し 2",
"name": "Bowbreaker 3",	"name": "弓殺し 3",
"name": "Daggerbreaker 1",	"name": "暗器殺し 1",
"name": "Daggerbreaker 2",	"name": "暗器殺し 2",
"name": "Daggerbreaker 3",	"name": "暗器殺し 3",
"name": "Lunge",	"name": "切り込み",
"name": "Knock Back",	"name": "叩き込み",
"name": "Drag Back",	"name": "引き込み",
"name": "Hone Atk 1",	"name": "攻撃の鼓舞 1",
"name": "Hone Atk 2",	"name": "攻撃の鼓舞 2",
"name": "Hone Atk 3",	"name": "攻撃の鼓舞 3",
"name": "Hone Spd 1",	"name": "速さの鼓舞 1",
"name": "Hone Spd 2",	"name": "速さの鼓舞 2",
"name": "Hone Spd 3",	"name": "速さの鼓舞 3",
"name": "Fortify Def 1",	"name": "守備の鼓舞 1",
"name": "Fortify Def 2",	"name": "守備の鼓舞 2",
"name": "Fortify Def 3",	"name": "守備の鼓舞 3",
"name": "Fortify Res 1",	"name": "魔防の鼓舞 1",
"name": "Fortify Res 2",	"name": "魔防の鼓舞 2",
"name": "Fortify Res 3",	"name": "魔防の鼓舞 3",
"name": "Spur Atk 1",	"name": "攻撃の紋章 1",
"name": "Spur Atk 2",	"name": "攻撃の紋章 2",
"name": "Spur Atk 3",	"name": "攻撃の紋章 3",
"name": "Spur Spd 1",	"name": "速さの紋章 1",
"name": "Spur Spd 2",	"name": "速さの紋章 2",
"name": "Spur Spd 3",	"name": "速さの紋章 3",
"name": "Spur Def 1",	"name": "守備の紋章 1",
"name": "Spur Def 2",	"name": "守備の紋章 2",
"name": "Spur Def 3",	"name": "守備の紋章 3",
"name": "Spur Res 1",	"name": "魔防の紋章 1",
"name": "Spur Res 2",	"name": "魔防の紋章 2",
"name": "Spur Res 3",	"name": "魔防の紋章 3",
"name": "Threaten Atk 1",	"name": "攻撃の威嚇 1",
"name": "Threaten Atk 2",	"name": "攻撃の威嚇 2",
"name": "Threaten Atk 3",	"name": "攻撃の威嚇 3",
"name": "Threaten Spd 1",	"name": "速さの威嚇 1",
"name": "Threaten Spd 2",	"name": "速さの威嚇 2",
"name": "Threaten Spd 3",	"name": "速さの威嚇 3",
"name": "Threaten Def 1",	"name": "守備の威嚇 1",
"name": "Threaten Def 2",	"name": "守備の威嚇 2",
"name": "Threaten Def 3",	"name": "守備の威嚇 3",
"name": "Threaten Res 1",	"name": "魔防の威嚇 1",
"name": "Threaten Res 2",	"name": "魔防の威嚇 2",
"name": "Threaten Res 3",	"name": "魔防の威嚇 3",
"name": "Savage Blow 1",	"name": "死の吐息 1",
"name": "Savage Blow 2",	"name": "死の吐息 2",
"name": "Savage Blow 3",	"name": "死の吐息 3",
"name": "Breath of Life 1",	"name": "生の息吹 1",
"name": "Breath of Life 2",	"name": "生の息吹 2",
"name": "Breath of Life 3",	"name": "生の息吹 3",
"name": "Hone Armor",	"name": "重刃の鼓舞",
"name": "Fortify Armor",	"name": "重盾の鼓舞",
"name": "Goad Armor",	"name": "重刃の紋章",
"name": "Ward Armor",	"name": "重盾の紋章",
"name": "Hone Fliers",	"name": "飛刃の鼓舞",
"name": "Fortify Fliers",	"name": "飛盾の鼓舞",
"name": "Goad Fliers",	"name": "飛刃の紋章",
"name": "Ward Fliers",	"name": "飛盾の紋章",
"name": "Hone Cavalry",	"name": "騎刃の鼓舞",
"name": "Fortify Cavalry",	"name": "騎盾の鼓舞",
"name": "Goad Cavalry",	"name": "騎刃の紋章",
"name": "Ward Cavalry",	"name": "騎盾の紋章",
"name": "Fortify Dragons",	"name": "竜盾の鼓舞",
"name": "Iote's Shield",	"name": "アイオテの盾",
"name": "Swift Sparrow 1",	"name": "鬼神飛燕の一撃 1",
"name": "Swift Sparrow 2",	"name": "鬼神飛燕の一撃 2",
"name": "Carrot Lance",	"name": "ニンジンの槍",
"name": "Carrot Lance+",	"name": "ニンジンの槍+",
"name": "Carrot Axe",	"name": "ニンジンの斧",
"name": "Carrot Axe+",	"name": "ニンジンの斧+",
"name": "Blue Egg",	"name": "青の卵",
"name": "Blue Egg+",	"name": "青の卵+",
"name": "Green Egg",	"name": "緑の卵",
"name": "Green Egg+",	"name": "緑の卵+",
"name": "Attack Def 1",	"name": "攻撃守備 1",
"name": "Attack Def 2",	"name": "攻撃守備 2",
"name": "Axe Experience 1",	"name": "斧の経験 1",
"name": "Axe Experience 2",	"name": "斧の経験 2",
"name": "Axe Experience 3",	"name": "斧の経験 3",
"name": "Live for Honor",	"name": "栄誉の喜び",
"name": "Live for Bounty",	"name": "豊穣の喜び",
"name": "Attack 1",	"name": "攻撃 1",
"name": "Resistance 1",	"name": "魔防 1",
"name": "Speed 1",	"name": "速さ 1",
"name": "HP +3",	"name": "ＨＰ 1",
"name": "Windsweep 1",	"name": "風薙ぎ 1",
"name": "Windsweep 2",	"name": "風薙ぎ 2",
"name": "Windsweep 3",	"name": "風薙ぎ 3",
"name": "Hit and Run",	"name": "一撃離脱",
"name": "Fortress Def 1",	"name": "守備の城塞 1",
"name": "Fortress Def 2",	"name": "守備の城塞 2",
"name": "Fortress Def 3",	"name": "守備の城塞 3",
"name": "Firesweep Bow",	"name": "火薙ぎの弓",
"name": "Firesweep Bow+",	"name": "火薙ぎの弓+",
"name": "Bow Experience 1",	"name": "弓の経験 1",
"name": "Bow Experience 2",	"name": "弓の経験 2",
"name": "Bow Experience 3",	"name": "弓の経験 3",
"name": "Eckesachs",	"name": "エッケザックス",
"name": "Ragnell",	"name": "ラグネル",
"name": "Heavy Blade 1",	"name": "剛剣 1",
"name": "Heavy Blade 2",	"name": "剛剣 2",
"name": "Heavy Blade 3",	"name": "剛剣 3",
"name": "Spur Def Res 1",	"name": "守備魔防の紋章 1",
"name": "Spur Def Res 2",	"name": "守備魔防の紋章 2",
"name": "Rexcalibur+",	"name": "レクスカリバー+",
"name": "Guard 1",	"name": "キャンセル 1",
"name": "Guard 2",	"name": "キャンセル 2",
"name": "Guard 3",	"name": "キャンセル 3",
"name": "Watersweep 1",	"name": "水薙ぎ 1",
"name": "Watersweep 2",	"name": "水薙ぎ 2",
"name": "Watersweep 3",	"name": "水薙ぎ 3",
"name": "Siegfried",	"name": "ジークフリート",
"name": "Gronnowl",	"name": "グルンアウル",
"name": "Gronnowl+",	"name": "グルンアウル+",
"name": "Earth Boost 1",	"name": "生命の大地 1",
"name": "Earth Boost 2",	"name": "生命の大地 2",
"name": "Earth Boost 3",	"name": "生命の大地 3",
"name": "Ragnarok",	"name": "ライナロック",
"name": "Distant Def 1",	"name": "遠距離防御 1",
"name": "Distant Def 2",	"name": "遠距離防御 2",
"name": "Distant Def 3",	"name": "遠距離防御 3",
"name": "Wrathful Staff 1",	"name": "神罰の杖 1",
"name": "Wrathful Staff 2",	"name": "神罰の杖 2",
"name": "Wrathful Staff 3",	"name": "神罰の杖 3",
"name": "Blarowl",	"name": "ブラーアウル",
"name": "Blarowl+",	"name": "ブラーアウル+",
"name": "B Tome Exp. 1",	"name": "青魔の経験 1",
"name": "B Tome Exp. 2",	"name": "青魔の経験 2",
"name": "B Tome Exp. 3",	"name": "青魔の経験 3",
"name": "Regal Blade",	"name": "リガルブレイド",
"name": "Blessed Bouquet",	"name": "聖なるブーケ",
"name": "Blessed Bouquet+",	"name": "聖なるブーケ+",
"name": "Attack Res 1",	"name": "攻撃魔防 1",
"name": "Attack Res 2",	"name": "攻撃魔防 2",
"name": "Gradivus",	"name": "グラディウス",
"name": "Grani's Shield",	"name": "グラ二の盾",
"name": "First Bite",	"name": "ファーストバイト",
"name": "First Bite+",	"name": "ファーストバイト+",
"name": "Wind Boost 1",	"name": "生命の疾風 1",
"name": "Wind Boost 2",	"name": "生命の疾風 2",
"name": "Wind Boost 3",	"name": "生命の疾風 3",
"name": "Cupid Arrow",	"name": "キューピッドの矢",
"name": "Cupid Arrow+",	"name": "キューピッドの矢+",
"name": "Rally Attack Speed",	"name": "攻撃速さの応援",
"name": "Candlelight",	"name": "キャンドルサービス",
"name": "Dazzling Staff 1",	"name": "幻惑の杖 1",
"name": "Dazzling Staff 2",	"name": "幻惑の杖 2",
"name": "Dazzling Staff 3",	"name": "幻惑の杖 3",
"name": "Fortify Res 1",	"name": "魔防の鼓舞 1",
"name": "Spur Def 1",	"name": "守備の紋章 1",
"name": "Quickened Pulse",	"name": "奥義の鼓動",
"name": "Breath of Life 1",	"name": "生の息吹 1",
"name": "Embla's Ward",	"name": "エンブラの加護",
"name": "Raudrowl",	"name": "ラウアアウル",
"name": "Raudrowl+",	"name": "ラウアアウル+",
"name": "Atk Ploy 1",	"name": "攻撃の謀策 1",
"name": "Atk Ploy 2",	"name": "攻撃の謀策 2",
"name": "Atk Ploy 3",	"name": "攻撃の謀策 3",
"name": "Sturdy Blow 1",	"name": "鬼神金剛の一撃 1",
"name": "Sturdy Blow 2",	"name": "鬼神金剛の一撃 2",
"name": "Sword Exp. 1",	"name": "剣の経験 1",
"name": "Sword Exp. 2",	"name": "剣の経験 2",
"name": "Sword Exp. 3",	"name": "剣の経験 3",
"name": "Firesweep Lance",	"name": "火薙ぎの槍",
"name": "Firesweep Lance+",	"name": "火薙ぎの槍+",
"name": "Rally Defense Resist",	"name": "守備魔防の応援",
"name": "Drive Def 1",	"name": "守備の大紋章 1",
"name": "Drive Def 2",	"name": "守備の大紋章 2",
"name": "Fire Boost 1",	"name": "生命の業火 1",
"name": "Fire Boost 2",	"name": "生命の業火 2",
"name": "Fire Boost 3",	"name": "生命の業火 3",
"name": "Panic Ploy 1",	"name": "恐慌の奇策 1",
"name": "Panic Ploy 2",	"name": "恐慌の奇策 2",
"name": "Panic Ploy 3",	"name": "恐慌の奇策 3",
"name": "Legion's Axe",	"name": "ローローの斧",
"name": "Legion's Axe+",	"name": "ローローの斧+",
"name": "Clarisse's Bow",	"name": "クライネの弓",
"name": "Clarisse's Bow+",	"name": "クライネの弓+",
"name": "Seashell",	"name": "貝殻",
"name": "Seashell+",	"name": "貝殻+",
"name": "Seal Atk Spd 1",	"name": "攻撃速さ封じ 1",
"name": "Seal Atk Spd 2",	"name": "攻撃速さ封じ 2",
"name": "Refreshing Bolt",	"name": "氷菓子の弓",
"name": "Refreshing Bolt+",	"name": "氷菓子の弓+",
"name": "Def Ploy 1",	"name": "守備の謀策 1",
"name": "Def Ploy 2",	"name": "守備の謀策 2",
"name": "Def Ploy 3",	"name": "守備の謀策 3",
"name": "Deft Harpoon",	"name": "魚を突いた銛",
"name": "Deft Harpoon+",	"name": "魚を突いた銛+",
"name": "Lance Valor 1",	"name": "槍の技量 1",
"name": "Lance Valor 2",	"name": "槍の技量 2",
"name": "Lance Valor 3",	"name": "槍の技量 3",
"name": "Melon Crusher",	"name": "スイカ割りの棍棒",
"name": "Melon Crusher+",	"name": "スイカ割りの棍棒+",
"name": "HP Def 1",	"name": "ＨＰ守備 1",
"name": "HP Def 2",	"name": "ＨＰ守備 2",
"name": "Close Def 1",	"name": "近距離防御 1",
"name": "Close Def 2",	"name": "近距離防御 2",
"name": "Close Def 3",	"name": "近距離防御 3",
"name": "Axe Valor 1",	"name": "斧の技量 1",
"name": "Axe Valor 2",	"name": "斧の技量 2",
"name": "Axe Valor 3",	"name": "斧の技量 3",
"name": "Dark Aura",	"name": "共鳴オーラ",
"name": "Drive Atk 1",	"name": "攻撃の大紋章 1",
"name": "Drive Atk 2",	"name": "攻撃の大紋章 2",
"name": "Dark Excalibur",	"name": "共鳴エクスカリバー",
"name": "Mirror Strike 1",	"name": "鬼神明鏡の一撃 1",
"name": "Mirror Strike 2",	"name": "鬼神明鏡の一撃 2",
"name": "Res Ploy 1",	"name": "魔防の謀策 1",
"name": "Res Ploy 2",	"name": "魔防の謀策 2",
"name": "Res Ploy 3",	"name": "魔防の謀策 3",
"name": "Zanbato",	"name": "斬馬刀",
"name": "Zanbato+",	"name": "斬馬刀+",
"name": "Sword Valor 1",	"name": "剣の技量 1",
"name": "Sword Valor 2",	"name": "剣の技量 2",
"name": "Sword Valor 3",	"name": "剣の技量 3",
"name": "Slaying Bow",	"name": "キラーボウ鍛",
"name": "Slaying Bow+",	"name": "キラーボウ鍛+",
"name": "Slaying Edge",	"name": "キルソード鍛",
"name": "Slaying Edge+",	"name": "キルソード鍛+",
"name": "HP Spd 1",	"name": "ＨＰ速さ 1",
"name": "HP Spd 2",	"name": "ＨＰ速さ 1",
"name": "Shield Pulse 1",	"name": "盾の鼓動 1",
"name": "Shield Pulse 2",	"name": "盾の鼓動 2",
"name": "Shield Pulse 3",	"name": "盾の鼓動 3",
"name": "Ridersbane",	"name": "ホースキラー",
"name": "Ridersbane+",	"name": "ホースキラー+",
"name": "Cancel Affinity 1",	"name": "相性相殺 1",
"name": "Cancel Affinity 2",	"name": "相性相殺 2",
"name": "Cancel Affinity 3",	"name": "相性相殺 3",
"name": "Berkut's Lance",	"name": "ベルクトの槍",
"name": "Berkut's Lance+",	"name": "ベルクトの槍+",
"name": "Water Boost 1",	"name": "生命の静水 1",
"name": "Water Boost 2",	"name": "生命の静水 2",
"name": "Water Boost 3",	"name": "生命の静水 3",
"name": "Phantom Spd 1",	"name": "速さの虚勢 1",
"name": "Sealife Tome",	"name": "熱帯魚の本",
"name": "Sealife Tome+",	"name": "熱帯魚の本+",
"name": "Swift Strike 1",	"name": "飛燕明鏡の一撃 1",
"name": "Swift Strike 2",	"name": "飛燕明鏡の一撃 2",
"name": "Tomato Tome",	"name": "トマトの本",
"name": "Tomato Tome+",	"name": "トマトの本+",
"name": "Lilith Floatie",	"name": "リリスの浮き輪",
"name": "Lilith Floatie+",	"name": "リリスの浮き輪+",
"name": "Infantry Pulse 1",	"name": "歩行の鼓動 1",
"name": "Infantry Pulse 2",	"name": "歩行の鼓動 2",
"name": "Infantry Pulse 3",	"name": "歩行の鼓動 3",
"name": "Hibiscus Tome",	"name": "リリスの浮き輪",
"name": "Hibiscus Tome+",	"name": "リリスの浮き輪+",
"name": "G Tome Valor 1",	"name": "緑魔の技量 1",
"name": "G Tome Valor 2",	"name": "緑魔の技量 2",
"name": "G Tome Valor 3",	"name": "緑魔の技量 3",
"name": "Rally Attack Resista",	"name": "攻撃魔防の応援",
"name": "Spd Res 1",	"name": "速さ魔防 1",
"name": "Spd Res 2",	"name": "速さ魔防 2",
"name": "Slaying Axe",	"name": "キラーアクス鍛",
"name": "Slaying Axe+",	"name": "キラーアクス鍛+",
"name": "Armor March 1",	"name": "重装の行軍 1",
"name": "Armor March 2",	"name": "重装の行軍 2",
"name": "Armor March 3",	"name": "重装の行軍 3",
"name": "Nidhogg",	"name": "ニーズヘッグ",
"name": "Fortress Res 1",	"name": "魔防の城塞 1",
"name": "Fortress Res 2",	"name": "魔防の城塞 2",
"name": "Fortress Res 3",	"name": "魔防の城塞 3",
"name": "Vidofnir",	"name": "ヴィドフニル",
"name": "Spd Def 1",	"name": "速さ守備 1",
"name": "Spd Def 2",	"name": "速さ守備 2",
"name": "Guidance 1",	"name": "空からの先導 1",
"name": "Guidance 2",	"name": "空からの先導 2",
"name": "Guidance 3",	"name": "空からの先導 3",
"name": "Seal Atk Def 1",	"name": "攻撃守備封じ 1",
"name": "Seal Atk Def 2",	"name": "攻撃守備封じ 2",
"name": "Cursed Lance",	"name": "魔性の槍",
"name": "Defense 1",	"name": "守備 1",
"name": "Hardy Bearing 1",	"name": "不動の姿勢 1",
"name": "Urvan",	"name": "ウルヴァン",
"name": "Steady Stance 1",	"name": "金剛の構え 1",
"name": "Steady Stance 2",	"name": "金剛の構え 2",
"name": "Steady Breath",	"name": "金剛の呼吸",
"name": "Beorc's Blessing",	"name": "ベオクの加護",
"name": "Mulagir",	"name": "ミュルグレ",
"name": "Sacae's Blessing",	"name": "サカの加護",
"name": "Atk Smoke 1",	"name": "攻撃の紫煙 1",
"name": "Atk Smoke 2",	"name": "攻撃の紫煙 2",
"name": "Atk Smoke 3",	"name": "攻撃の紫煙 3",
"name": "Geirskogul",	"name": "ゲイルスケグル",
"name": "Drive Spd 1",	"name": "速さの大紋章 1",
"name": "Drive Spd 2",	"name": "速さの大紋章 2",
"name": "Blazing Durandal",	"name": "烈剣デュランダル",
"name": "Steady Blow 1",	"name": "飛燕金剛の一撃 1",
"name": "Steady Blow 2",	"name": "飛燕金剛の一撃 2",
"name": "Distant Def 1",	"name": "遠距離防御 1",
"name": "Atk Ploy 1",	"name": "攻撃の謀策 1",
"name": "Amiti",	"name": "アミーテ",
"name": "Flier Formation 1",	"name": "編隊飛行 1",
"name": "Flier Formation 2",	"name": "編隊飛行 2",
"name": "Flier Formation 3",	"name": "編隊飛行 3",
"name": "Slaying Lance",	"name": "キラーランス鍛",
"name": "Slaying Lance+",	"name": "キラーランス鍛+",
"name": "Atk Spd 1",	"name": "攻撃速さ 1",
"name": "Atk Spd 2",	"name": "攻撃速さ 2",
"name": "Wrath 1",	"name": "怒り 1",
"name": "Wrath 2",	"name": "怒り 2",
"name": "Wrath 3",	"name": "怒り 3",
"name": "Rally Speed Defense",	"name": "速さ守備の応援",
"name": "Spur Spd Def 1",	"name": "速さ守備の紋章 1",
"name": "Spur Spd Def 2",	"name": "速さ守備の紋章 2",
"name": "Alondite",	"name": "エタルド",
"name": "Black Luna",	"name": "黒の月光",
"name": "Steady Stance 3",	"name": "金剛の構え 3",
"name": "Panic Ploy 1",	"name": "恐慌の奇策 1",
"name": "Uror",	"name": "ウルズ",
"name": "Drive Res 1",	"name": "魔防の大紋章 1",
"name": "Drive Res 2",	"name": "魔防の大紋章 2",
"name": "Dancer's Ring",	"name": "舞踏祭の輪",
"name": "Dancer's Ring+",	"name": "舞踏祭の輪+ ",
"name": "Gale Dance 1",	"name": "疾風の舞い 1",
"name": "Gale Dance 2",	"name": "疾風の舞い 2",
"name": "Gale Dance 3",	"name": "疾風の舞い 3",
"name": "Dancer's Fan",	"name": "舞踏祭の扇子",
"name": "Dancer's Fan+",	"name": "舞踏祭の扇子+",
"name": "Blaze Dance 1",	"name": "業火の舞い 1",
"name": "Blaze Dance 2",	"name": "業火の舞い 2",
"name": "Blaze Dance 3",	"name": "業火の舞い 3",
"name": "Dancer's Score",	"name": "舞踏祭の楽譜",
"name": "Dancer's Score+",	"name": "舞踏祭の楽譜+",
"name": "Torrent Dance 1",	"name": "静水の舞い 1",
"name": "Geyser Dance 1",	"name": "大地静水の舞い 1",
"name": "Geyser Dance 2",	"name": "大地静水の舞い 2",
"name": "B Tome Valor 1",	"name": "青魔の技量 1",
"name": "B Tome Valor 2",	"name": "青魔の技量 2",
"name": "B Tome Valor 3",	"name": "青魔の技量 3",
"name": "Phantom Spd 2",	"name": "速さの虚勢 2",
"name": "Phantom Spd 3",	"name": "速さの虚勢 3",
"name": "Panic Ploy 2",	"name": "恐慌の奇策 2",
"name": "Panic Ploy 3",	"name": "恐慌の奇策 3",
"name": "Hardy Bearing 2",	"name": "不動の姿勢 2",
"name": "Hardy Bearing 3",	"name": "不動の姿勢 3",
"name": "Atk Ploy 2",	"name": "攻撃の謀策 2",
"name": "Atk Ploy 3",	"name": "攻撃の謀策 3",
"name": "Breath of Life 2",	"name": "生の息吹 2",
"name": "Breath of Life 3",	"name": "生の息吹 3",
"name": "Distant Def 2",	"name": "遠距離防御 2",
"name": "Distant Def 3",	"name": "遠距離防御 3",
"name": "Deflect Magic 1",	"name": "連撃防御・魔道 1",
"name": "Deflect Magic 2",	"name": "連撃防御・魔道 2",
"name": "Deflect Magic 3",	"name": "連撃防御・魔道 3",
"name": "Deflect Melee 1",	"name": "連撃防御・剣槍斧 1",
"name": "Deflect Melee 2",	"name": "連撃防御・剣槍斧 2",
"name": "Deflect Melee 3",	"name": "連撃防御・剣槍斧 3",
"name": "Deflect Missile 1",	"name": "連撃防御・弓暗器 1",
"name": "Deflect Missile 2",	"name": "連撃防御・弓暗器 2",
"name": "Deflect Missile 3",	"name": "連撃防御・弓暗器 3",
"name": "HP +4",	"name": "ＨＰ 2",
"name": "HP +5",	"name": "ＨＰ 3",
"name": "Attack +2",	"name": "攻撃 2",
"name": "Attack +3",	"name": "攻撃 3",
"name": "Speed +2",	"name": "速さ 2",
"name": "Speed +3",	"name": "速さ 3",
"name": "Defense +2",	"name": "守備 2",
"name": "Defense +3",	"name": "守備 3",
"name": "Resistance +2",	"name": "魔防 2",
"name": "Resistance +3",	"name": "魔防 3",
"name": "Fortify Def 2",	"name": "守備の鼓舞 2",
"name": "Fortify Def 3",	"name": "守備の鼓舞 3",
"name": "Fortify Res 2",	"name": "魔防の鼓舞 2",
"name": "Fortify Res 3",	"name": "魔防の鼓舞 3",
"name": "Spur Atk 1",	"name": "攻撃の紋章 1",
"name": "Spur Atk 2",	"name": "攻撃の紋章 2",
"name": "Spur Atk 3",	"name": "攻撃の紋章 3",
"name": "Spur Spd 1",	"name": "速さの紋章 1",
"name": "Spur Spd 2",	"name": "速さの紋章 2",
"name": "Spur Spd 3",	"name": "速さの紋章 3",
"name": "Spur Def 1",	"name": "守備の紋章 1",
"name": "Spur Def 2",	"name": "守備の紋章 2",
"name": "Spur Def 3",	"name": "守備の紋章 3",
"name": "Spur Res 1",	"name": "魔防の紋章 1",
"name": "Spur Res 2",	"name": "魔防の紋章 2",
"name": "Spur Res 3",	"name": "魔防の紋章 3",
"name": "Divine Tyrfing",	"name": "聖剣ティルフィング",
"name": "Crusader's Ward",	"name": "聖騎士の加護",
"name": "Spd Smoke 1",	"name": "速さの紫煙 1",
"name": "Spd Smoke 2",	"name": "速さの紫煙 2",
"name": "Spd Smoke 3",	"name": "速さの紫煙 3",
"name": "Ayra's Blade",	"name": "瞬閃アイラの剣",
"name": "Regnal Astra",	"name": "剣姫の流星",
"name": "Divine Naga",	"name": "聖書ナーガ",
"name": "Spd Ploy 1",	"name": "速さの謀策 1",
"name": "Spd Ploy 2",	"name": "速さの謀策 2",
"name": "Spd Ploy 3",	"name": "速さの謀策 3",
"name": "Rally Speed Resistance",	"name": "速さ魔防の応援",
"name": "Follow-Up Ring",	"name": "追撃リング",
"name": "Valflame",	"name": "ファラフレイム",
"name": "Recover Ring",	"name": "リカバーリング",
"name": "Squad Ace A 1",	"name": "第１迷宮の覇者 1",
"name": "Squad Ace A 2",	"name": "第１迷宮の覇者 2",
"name": "Squad Ace A 3",	"name": "第１迷宮の覇者 3",
"name": "Squad Ace B 1",	"name": "第２迷宮の覇者 1",
"name": "Squad Ace B 2",	"name": "第２迷宮の覇者 2",
"name": "Squad Ace B 3",	"name": "第２迷宮の覇者 3",
"name": "Squad Ace C 1",	"name": "第３迷宮の覇者 1",
"name": "Squad Ace C 2",	"name": "第３迷宮の覇者 2",
"name": "Squad Ace C 3",	"name": "第３迷宮の覇者 3",
"name": "Squad Ace D 1",	"name": "第４迷宮の覇者 1",
"name": "Squad Ace D 2",	"name": "第４迷宮の覇者 2",
"name": "Squad Ace D 3",	"name": "第４迷宮の覇者 3",
"name": "Squad Ace E 1",	"name": "第５迷宮の覇者 1",
"name": "Squad Ace E 2",	"name": "第５迷宮の覇者 2",
"name": "Squad Ace E 3",	"name": "第５迷宮の覇者 3",
"name": "Spectral Tome",	"name": "ゴーストの魔道書",
"name": "Spectral Tome+",	"name": "ゴーストの魔道書+",
"name": "Monstrous Bow",	"name": "怪物の弓",
"name": "Monstrous Bow+",	"name": "怪物の弓+",
"name": "Bracing Blow 1",	"name": "金剛明鏡の一撃 1",
"name": "Bracing Blow 2",	"name": "金剛明鏡の一撃 2",
"name": "Grimoire",	"name": "グリモワール",
"name": "Atk Res Bond 1",	"name": "攻撃魔防の絆 1",
"name": "Atk Res Bond 2",	"name": "攻撃魔防の絆 2",
"name": "Atk Res Bond 3",	"name": "攻撃魔防の絆 3",
"name": "Kitty Paddle",	"name": "猫の暗器",
"name": "Kitty Paddle+",	"name": "猫の暗器+",
"name": "Warding Stance 1",	"name": "明鏡の構え 1",
"name": "Warding Stance 2",	"name": "明鏡の構え 2",
"name": "Warding Stance 3",	"name": "明鏡の構え 3",
"name": "Dagger Valor 1",	"name": "暗器の技量 1",
"name": "Dagger Valor 2",	"name": "暗器の技量 2",
"name": "Dagger Valor 3",	"name": "暗器の技量 3",
"name": "Stout Tomahawk",	"name": "剛斧トマホーク",
"name": "Fierce Stance 1",	"name": "鬼神の構え 1",
"name": "Fierce Stance 2",	"name": "鬼神の構え 2",
"name": "Fierce Stance 3",	"name": "鬼神の構え 3",
"name": "Weirding Tome",	"name": "奇異ルーテの書",
"name": "HP Res 1",	"name": "ＨＰ魔防 1",
"name": "HP Res 2",	"name": "ＨＰ魔防 2",
"name": "Resolute Blade",	"name": "気鋭ワユの剣",
"name": "Flashing Blade 1",	"name": "柔剣 1",
"name": "Flashing Blade 2",	"name": "柔剣 2",
"name": "Flashing Blade 3",	"name": "柔剣 3",
"name": "Audhulma",	"name": "氷剣アウドムラ"
